:--:--:--:--:  :--:
|     |     |  |  |
:  :--:  :  :  :  :
|  |     |        |
:  :  :  :--:--:--:
|  |  |           |
:  :  :--:--:--:  :
|  |        |  |  |
:  :--:--:  :  :  :
|     |     |  |  |
:--:  :  :--:  :  :
|        |        |
:  :--:--:--:--:--: